3
0
0
2
22222222222222222222222222222222222222222222222222222222222222222222222222222222222222222222222222222222222222
20000000000000000000000000000000000000000000000000001000000000000000000000000000000000000000000000000000000002
20000000000000000000000000000000000000000000000000001000000000000000000000000000000000000000000000000000000002
20000000000011111111111000000000000000000000000000001000000000000000000000000000000000011111111111000000000002
20000000000012222222221000000000000000000000000000001000000000000000000000000000000000012222222221000000000002
20000000000012222222221000000000000000000000000000001000000000000000000000000000000000012222222221000000000002
20000000000012222222221000000000000000000000000000001000000000000000000000000000000000012222222221000000000002
20000000000012222222221000000000000000000000000000001000000000000000000000000000000000012222222221000000000002
20000000000012222222221000000000000000000000000000001000000000000000000000000000000000012222222221000000000002
20000000000012222222221000000000000000000000000000001000000000000000000000000000000000012222222221000000000002
20000000000012222222221000000000000000000000000000001000000000000000000000000000000000012222222221000000000002
20000000000012222222221000000000000000000000000000001000000000000000000000000000000000012222222221000000000002
20000000000011111111111000000000000000000000000000001000000000000000000000000000000000011111111111000000000002
20000000000000000000000000000000000000000000000000001000000000000000000000000000000000000000000000000000000002
20000000000000000000000000000000000000000000000000001000000000000000000000000000000000000000000000000000000002
20000000111111111111111111111111111111111111111211111111111111111111111111111111111111111111111111111100000002
20000000000000000000000000000000000000000000000000001000000000000000000000000000000000000000000000000000000002
20000000000000000000000000000000000000000000000000001000000000000000000000000000000000000000000000000000000002
20000000000011111111111000000000000000000000000000001000000000000000000000000000000000011111111111000000000002
20000000000012222222221000000000000000000000000000001000000000000000000000000000000000012222222221000000000002
20000000000012222222221000000000000000000000000000001000000000000000000000000000000000012222222221000000000002
20000000000012222222221000000000000000000000000000001000000000000000000000000000000000012222222221000000000002
20000000000012222222221000000000000000000000000000001000000000000000000000000000000000012222222221000000000002
20000000000012222222221000000000000000000000000000001000000000000000000000000000000000012222222221000000000002
20000000000012222222221000000000000000000000000000001000000000000000000000000000000000012222222221000000000002
20000000000012222222221000000000000000000000000000001000000000000000000000000000000000012222222221000000000002
20000000000011111111111000000000000000000000000000001000000000000000000000000000000000011111111111000000000002
20000000000000000000000000000000000000000000000000001000000000000000000000000000000000000000000000000000000002
20000000000000000000000000000000000000000000000000001000000000000000000000000000000000000000000000000000000002
22222222222222222222222222222222222222222222222222222222222222222222222222222222222222222222222222222222222222
