211111111111111111112
100000000000000000001
100000000000000000001
100000007000000000001
100000000000000000001
100000000000000000001
100000000000000000001
100000000006000000001
100000000000000000001
100000000000000000001
100000000000000000001
100000000000000000001
100000000000000000001
100000000000000006001
100000000000000000001
100000000000000000001
100000000000000000001
100007000000000000001
100000000000000000001
100000000000000000001
211111111111111111112
