12
5
5
2
21111111111111111111111111111111111111111111111111112111111111111111111111111111111111111111111111111111111112
10000000000000000000000000000000000000000000000000001000000000000000000000000000000000000000000000000000000001
10000000000000000000000000000000000000000000000000001000000000000000000000000000000000000000000000000000000001
10000000000000000000000000000000000000000000000000001000000000000000000000000000000000000000000000000000000001
10000000000000000000000000000000000000000000000000001000000000000000000000000000000000000000000000000000000001
10000000000000000000000000000000000000000000000000001000000000000000000000000000000000000000000000000000000001
10000000000000000000000000000000000000000000000000001000000000000000000000000000000000000000000000000000000001
10000000000000000000000000000000000000000000000000001000000000000000000000000000000000000000000000000000000001
10000000000000000000000000000000000000000000000000001000000000000000000000000000000000000000000000000000000001
10000000000000000000000000000000000000000000000000001000000000000000000000000000000000000000000000000000000001
10000000000000000000000000000000000000000000000000001000000000000000000000000000000000000000000000000000000001
10000000000000000000000000000000000000000000000000001000000000000000000000000000000000000000000000000000000001
10000000000000000000000000000000000000000000000000001000000000000000000000000000000000000000000000000000000001
10000000000000000000000000000000000000000000000000001000000000000000000000000000000000000000000000000000000001
20000000000000000000000000000000000000000000000000002000000000000000000000000000000000000000000000000000000002
10000000000000000000000000000000000000000000000000001000000000000000000000000000000000000000000000000000000001
10000000000000000000000000000000000000000000000000001000000000000000000000000000000000000000000000000000000001
10000000000000000000000000000000000000000000000000001000000000000000000000000000000000000000000000000000000001
10000000000000000000000000000000000000000000000000001000000000000000000000000000000000000000000000000000000001
10000000000000000000000000000000000000000000000000001000000000000000000000000000000000000000000000000000000001
10000000000000000000000000000000000000000000000000001000000000000000000000000000000000000000000000000000000001
10000000000000000000000000000000000000000000000000001000000000000000000000000000000000000000000000000000000001
10000000000000000000000000000000000000000000000000001000000000000000000000000000000000000000000000000000000001
10000000000000000000000000000000000000000000000000001000000000000000000000000000000000000000000000000000000001
10000000000000000000000000000000000000000000000000001000000000000000000000000000000000000000000000000000000001
10000000000000000000000000000000000000000000000000001000000000000000000000000000000000000000000000000000000001
10000000000000000000000000000000000000000000000000001000000000000000000000000000000000000000000000000000000001
10000000000000000000000000000000000000000000000000001000000000000000000000000000000000000000000000000000000001
10000000000000000000000000000000000000000000000000001000000000000000000000000000000000000000000000000000000001
21111111111111111111111111111111111111111111111111112111111111111111111111111111111111111111111111111111111112
