3
0
0
2
22222222222222222222222222222222222222222222222222222222222222222222222222222222222222222222222222222222222222
20000000000000000000000000000000000000000000000000000000000000000000000000000000000000000000000000000000000002
20000000000000000000000000000000000000000000000000000000000000000000000000000000000000000000000000000000000002
20000000000000000000000000000000000000000000000000001000000000000000000000000000000000000000000000000000000002
20000000000000000000000000000000000000000000000000001000000000000000000000000000000000000000000000000000000002
20000000000000000000000000000000000000000000000000001000000000000000000000000000000000000000000000000000000002
20000000000000000000000000000000000000000000000000001000000000000000000000000000000000000000000000000000000002
20000000000000000000000000000000000000000000000000001000000000000000000000000000000000000000000000000000000002
20000000000000000000000000000000000000000000000000001000000000000000000000000000000000000000000000000000000002
20000000000000000000000000000000000000000000000000001000000000000000000000000000000000000000000000000000000002
20000000000000000000000000000000000000000000000000001000000000000000000000000000000000000000000000000000000002
20000000000000000000000000000000000000000000000000001000000000000000000000000000000000000000000000000000000002
20000000000000000000000000000000000000000000000000001000000000000000000000000000000000000000000000000000000002
20000000000000000000000000000000000000000000000000001000000000000000000000000000000000000000000000000000000002
20011111111111111111111111111111111111111111111111112111111111111111111111111111111111111111111111111111111002
20000000000000000000000000000000000000000000000000001000000000000000000000000000000000000000000000000000000002
20000000000000000000000000000000000000000000000000001000000000000000000000000000000000000000000000000000000002
20000000000000000000000000000000000000000000000000001000000000000000000000000000000000000000000000000000000002
20000000000000000000000000000000000000000000000000001000000000000000000000000000000000000000000000000000000002
20000000000000000000000000000000000000000000000000001000000000000000000000000000000000000000000000000000000002
20000000000000000000000000000000000000000000000000001000000000000000000000000000000000000000000000000000000002
20000000000000000000000000000000000000000000000000001000000000000000000000000000000000000000000000000000000002
20000000000000000000000000000000000000000000000000001000000000000000000000000000000000000000000000000000000002
20000000000000000000000000000000000000000000000000001000000000000000000000000000000000000000000000000000000002
20000000000000000000000000000000000000000000000000001000000000000000000000000000000000000000000000000000000002
20000000000000000000000000000000000000000000000000001000000000000000000000000000000000000000000000000000000002
20000000000000000000000000000000000000000000000000001000000000000000000000000000000000000000000000000000000002
20000000000000000000000000000000000000000000000000000000000000000000000000000000000000000000000000000000000002
20000000000000000000000000000000000000000000000000000000000000000000000000000000000000000000000000000000000002
22222222222222222222222222222222222222222222222222222222222222222222222222222222222222222222222222222222222222
